11111111111111111111111111111111111111111111111
10000000000000000000E00000000000000000000000001
10000000000000000000000000000000000000000000001
1000000000000000000000000C000000000000000000001
1000000000000000P000000000000C00000000000000001
10000000000000000000000000C00000000000000000001
10000000000000000000000000000000000000000000001
11111111111111111111111111111111111111111111111
