111111111111111
1001C100P1E0111
1C1101011110111
100000011100111
101111111101111
100000000001111
111111111111111
